##########
#S       #
#  ####  #
#     G  #
##########
