####################
#S   #        #   #
# #  ### ####### # #
# #   #   #     # #
###   ### ### ##### 
#   #     #   #   #
# ### ### ### ### #
#   # #   #   #   #
### # ##### ### ###
#   #           G #
####################
